

                   ############
                   #          #
  *######          #          #
        #          #          #
        #          #          #
        #          #          #######+
        #          #
        #          #
        #          #
        #          #
        ############